R 1200 600
NO ./assets/wall.xpm
SO ./assets/wall.xpm
WE ./assets/wall.xpm
EA ./assets/wall.xpm
S ./assets/pickle2.xpm
F 220,100,0
C 225,30,0
F 0,0,255

0
1111111111111111111111111
1000000000110000000000001
1011000001110000000000001
1001000000000000000000001
1000000000000000000000111
1000000000000000000000001
1000000000000000000000111
1000N00000000000000000001
1111111111111111111111111
